1000 und 1 Nacht - Klaus Lage
500 Miles - The Proclaimers
99 Luftballons - Nena
Alles neu - Peter Fox
Angels - Robbie Williams
Basket case - Green Day
Boulevard of broken dreams - Green Day
Brenna tuats guad - Hubert von Goisern
Britney Spears Medley - Britney Spears
Can't fight this feeling - REO Speedwagon
Can't stop - Red Hot Chilli Peppers
Creep - Radiohead
Dancing Queen - ABBA
Disney Medley - Sevenheaven
Don't stop believing - The Journey
Don't stop me now - Queen
Ein Kompliment - Sportfreunde Stiller
Fürstenfeld - S.T.S
Gimme gimme gimme - ABBA
Grace Kelly - MIKA
Griechischer Wein - Udo Jürgens
Ham kummst - Seiler und Speer
Hey Jude - The Beatles
Hold the line - Toto
Holiday - Green Day
Hollywood Hills - Sunrise Avenue
Hotel California - The Eagles
Hurra die Schule brennt - Extrabreit
Irgendwie irgendwo irgendwann - Nena
It's my life - Bon Jovi
Jetlag - Simple Plan
Jump - Van Halen
Little talks - Of Monsters and Men
Major Tom - Peter Schilling
More than you know - Axwell /\ Ingrosso
Narcotic - Liquido
Ohne dich - Münchner Freiheit
Papaoutai - Stromae
Que sera sera - Doris Day
Rockin' all over the world - Status Quo
Rolling in the deep - Adele
Ruby - Kaiser Chiefs
Schickeria - Spider Murphy Gang
Schrei nach Liebe - Die Ärzte
Seven nation army - The White Stripes
Sex on fire - Kings of Leon
Shallow - Lady Gaga
Skyfall - Adele
Summer of '69 - Bryan Adams
Sweet Caroline - DJ Ötzi
Sweet home Chicago - The Blues Brothers
Tage wie diese - Die Toten Hosen
This is the life - Amy Macdonald
This love - Maroon 5
Time warp - Rocky Horror Picture Show
Waterloo - ABBA
Weusd' a Herz hast - Rainhard Fendrich
Whatever it takes - Imagine Dragons
What's up - 4 Non Blondes
Wonderwall - Oasis